x___x_______
x___x_x_xx_x
xx__xxx__x__
xx__x___xx_x
x__xxx__x_xx
x____x__x___
__x__x_xx_x_
_xx_x_____x_
xx__x___x___
_xx_x_x_xxx_
_x_x__x_x___
+____x__x___
